Pais;Region;Casos totales;Fallecimientos;Recuperados;Casos activos;Casos cerrados;Fecha
North America;Total;464891;15678;28522;420691;44200;2020-04-09 11:46:00
Europe;Total;753822;62086;174104;517632;236190;2020-04-09 11:46:00
Asia;Total;255472;9618;125678;120176;135296;2020-04-09 11:46:00
South America;Total;35571;1400;3575;30596;4975;2020-04-09 11:46:00
Oceania;Total;7429;52;3305;4072;3357;2020-04-09 11:46:00
Africa;Total;12065;579;1473;10013;2052;2020-04-09 11:46:00
;Total;721;13;619;89;632;2020-04-09 11:46:00
World;Total;1529971;89426;337276;1103269;426702;2020-04-09 11:46:00
USA;USA Total;435160;14797;22891;397472;37688;2020-04-09 11:46:00
USA;New York;151171;6268;14580;130323;20848;2020-04-09 11:46:00
USA;New Jersey;47437;1504;92;45841;1596;2020-04-09 11:46:00
USA;Michigan;20346;959;69;19318;1028;2020-04-09 11:46:00
USA;California;19063;507;940;17616;1447;2020-04-09 11:46:00
USA;Louisiana;17030;652;50;16328;702;2020-04-09 11:46:00
USA;Massachusetts;16790;433;10;16347;443;2020-04-09 11:46:00
USA;Pennsylvania;16743;314;134;16295;448;2020-04-09 11:46:00
USA;Florida;15698;323;100;15275;423;2020-04-09 11:46:00
USA;Illinois;15078;462;50;14566;512;2020-04-09 11:46:00
USA;Georgia;10204;370;31;9803;401;2020-04-09 11:46:00
USA;Texas;10065;195;770;9100;965;2020-04-09 11:46:00
USA;Washington;9342;431;914;7997;1345;2020-04-09 11:46:00
USA;Connecticut;8781;335;50;8396;385;2020-04-09 11:46:00
USA;Indiana;5943;203;14;5726;217;2020-04-09 11:46:00
USA;Colorado;5655;193;40;5422;233;2020-04-09 11:46:00
USA;Maryland;5529;124;288;5117;412;2020-04-09 11:46:00
USA;Ohio;5148;193;0;4955;193;2020-04-09 11:46:00
USA;Tennessee;4362;79;627;3656;706;2020-04-09 11:46:00
USA;Virginia;3645;75;2;3568;77;2020-04-09 11:46:00
USA;North Carolina;3562;63;86;3413;149;2020-04-09 11:46:00
USA;Missouri;3431;85;69;3277;154;2020-04-09 11:46:00
USA;Wisconsin;2756;103;65;2588;168;2020-04-09 11:46:00
USA;Arizona;2726;80;20;2626;100;2020-04-09 11:46:00
USA;South Carolina;2552;63;0;2489;63;2020-04-09 11:46:00
USA;Alabama;2499;67;20;2412;87;2020-04-09 11:46:00
USA;Nevada;2318;71;36;2211;107;2020-04-09 11:46:00
USA;Mississippi;2003;67;0;1936;67;2020-04-09 11:46:00
USA;Utah;1846;13;26;1807;39;2020-04-09 11:46:00
USA;Oklahoma;1524;79;522;923;601;2020-04-09 11:46:00
USA;Rhode Island;1450;35;10;1405;45;2020-04-09 11:46:00
USA;District Of Columbia;1440;27;361;1052;388;2020-04-09 11:46:00
USA;Kentucky;1346;73;306;967;379;2020-04-09 11:46:00
USA;Oregon;1239;38;0;1201;38;2020-04-09 11:46:00
USA;Idaho;1232;18;0;1214;18;2020-04-09 11:46:00
USA;Minnesota;1154;39;632;483;671;2020-04-09 11:46:00
USA;Iowa;1145;27;89;1029;116;2020-04-09 11:46:00
USA;Delaware;1116;19;159;938;178;2020-04-09 11:46:00
USA;Arkansas;1077;18;237;822;255;2020-04-09 11:46:00
USA;Kansas;1046;38;0;1008;38;2020-04-09 11:46:00
USA;New Mexico;865;16;171;678;187;2020-04-09 11:46:00
USA;New Hampshire;788;18;227;543;245;2020-04-09 11:46:00
USA;Vermont;605;23;0;582;23;2020-04-09 11:46:00
USA;Maine;537;14;187;336;201;2020-04-09 11:46:00
USA;Nebraska;519;12;0;507;12;2020-04-09 11:46:00
USA;West Virginia;483;4;0;479;4;2020-04-09 11:46:00
USA;Hawaii;435;5;113;317;118;2020-04-09 11:46:00
USA;South Dakota;393;6;146;241;152;2020-04-09 11:46:00
USA;Montana;332;6;135;191;141;2020-04-09 11:46:00
USA;North Dakota;251;4;98;149;102;2020-04-09 11:46:00
USA;Wyoming;230;0;94;136;94;2020-04-09 11:46:00
USA;Alaska;226;7;32;187;39;2020-04-09 11:46:00
USA;Total;435160;14797;22891;187;39;2020-04-09 11:46:00
Spain;Andalucía;9261;;;;;2020-04-08 21:00:00
Spain;Aragón;3685;;;;;2020-04-08 21:00:00
Spain;Principado de Asturias;1737;;;;;2020-04-08 21:00:00
Spain;Islas Baleares;1448;;;;;2020-04-08 21:00:00
Spain;Canarias;1834;;;;;2020-04-08 21:00:00
Spain;Cantabria;1619;;;;;2020-04-08 21:00:00
Spain;Castilla y León;10518;;;;;2020-04-08 21:00:00
Spain;Castilla La Mancha;12489;;;;;2020-04-08 21:00:00
Spain;Cataluña;31043;;;;;2020-04-08 21:00:00
Spain;Galicia;6758;;;;;2020-04-08 21:00:00
Spain;C. Valenciana;7964;;;;;2020-04-08 21:00:00
Spain;Extremadura;2273;;;;;2020-04-08 21:00:00
Spain;Comunidad de Madrid;43877;;;;;2020-04-08 21:00:00
Spain;Región de Murcia;1356;;;;;2020-04-08 21:00:00
Spain;Comunidad Foral de Navarra;3575;;;;;2020-04-08 21:00:00
Spain;País Vasco;9806;;;;;2020-04-08 21:00:00
Spain;La Rioja;3026;;;;;2020-04-08 21:00:00
Spain;Ceuta;84;;;;;2020-04-08 21:00:00
Spain;Melilla;93;;;;;2020-04-08 21:00:00
Spain;Total;152446;15238;52165;85043;67403;2020-04-08 21:00:00
Italy;Lombardia;53414;9722;15147;28545;24869;2020-04-08 18:00:00
Italy;Emilia-Romagna;18234;2234;2890;13110;5124;2020-04-08 18:00:00
Italy;Piemonte;13883;1378;1516;10989;2894;2020-04-08 18:00:00
Italy;Veneto;12410;736;1503;10171;2239;2020-04-08 18:00:00
Italy;Toscana;6379;392;430;5557;822;2020-04-08 18:00:00
Italy;Liguria;4906;654;1007;3245;1661;2020-04-08 18:00:00
Italy;Marche;4859;652;645;3562;1297;2020-04-08 18:00:00
Italy;Trentino-Alto Adige;4437;438;778;3221;1216;2020-04-08 18:00:00
Italy;Lazio;4266;244;574;3448;818;2020-04-08 18:00:00
Italy;Campania;3268;221;188;2859;409;2020-04-08 18:00:00
Italy;Puglia;2634;219;177;2238;396;2020-04-08 18:00:00
Italy;Friuli-Venezia Giulia;2218;169;634;1415;803;2020-04-08 18:00:00
Italy;Sicilia;2159;133;133;1893;266;2020-04-08 18:00:00
Italy;Abruzzo;1859;179;146;1534;325;2020-04-08 18:00:00
Italy;Umbria;1289;50;416;823;466;2020-04-08 18:00:00
Italy;Sardegna;975;59;76;840;135;2020-04-08 18:00:00
Italy;Calabria;859;60;44;755;104;2020-04-08 18:00:00
Italy;Valle d'Aosta;850;102;142;606;244;2020-04-08 18:00:00
Italy;Basilicata;297;14;13;270;27;2020-04-08 18:00:00
Italy;Molise;226;13;32;181;45;2020-04-08 18:00:00
Italy;Total;139422;17669;26491;95262;44160;2020-04-08 18:00:00
Germany;Total;113296;2349;46300;64647;48649;2020-04-09 11:46:00
France;Total;112950;10869;21254;80827;32123;2020-04-09 11:46:00
Iran;Total;64586;3993;29812;30781;33805;2020-04-09 11:46:00
UK;Total;60733;7097;135;53501;7232;2020-04-09 11:46:00
Turkey;Total;38226;812;1846;35568;2658;2020-04-09 11:46:00
Belgium;Total;24983;2523;5164;17296;7687;2020-04-09 11:46:00
Switzerland;Total;23514;913;9800;12801;10713;2020-04-09 11:46:00
Netherlands;Total;20549;2248;250;18051;2498;2020-04-09 11:46:00
Canada;Total;19438;435;4653;14350;5088;2020-04-09 11:46:00
Brazil;Total;16238;823;173;15242;996;2020-04-09 11:46:00
Portugal;Total;13141;380;196;12565;576;2020-04-09 11:46:00
Austria;Total;13074;295;5240;7539;5535;2020-04-09 11:46:00
S. Korea;Total;10423;204;6973;3246;7177;2020-04-09 11:46:00
Russia;Total;10131;76;698;9357;774;2020-04-09 11:46:00
Israel;Total;9755;79;864;8812;943;2020-04-09 11:46:00
Sweden;Total;8419;687;205;7527;892;2020-04-09 11:46:00
India;Total;6237;186;569;5482;755;2020-04-09 11:46:00
Australia;Total;6104;51;2987;3066;3038;2020-04-09 11:46:00
Ireland;Total;6074;235;25;5814;260;2020-04-09 11:46:00
Norway;Total;6042;101;32;5909;133;2020-04-09 11:46:00
Chile;Total;5546;48;1115;4383;1163;2020-04-09 11:46:00
Denmark;Total;5402;218;1621;3563;1839;2020-04-09 11:46:00
Poland;Total;5341;164;284;4893;448;2020-04-09 11:46:00
Czechia;Total;5335;104;243;4988;347;2020-04-09 11:46:00
Romania;Total;5202;229;647;4326;876;2020-04-09 11:46:00
Japan;Total;4667;94;632;3941;726;2020-04-09 11:46:00
Ecuador;Total;4450;242;140;4068;382;2020-04-09 11:46:00
Pakistan;Total;4414;63;572;3779;635;2020-04-09 11:46:00
Peru;Total;4342;121;1333;2888;1454;2020-04-09 11:46:00
Malaysia;Total;4228;67;1608;2553;1675;2020-04-09 11:46:00
Philippines;Total;4076;203;124;3749;327;2020-04-09 11:46:00
Indonesia;Total;3293;280;252;2761;532;2020-04-09 11:46:00
Mexico;Total;3181;174;633;2374;807;2020-04-09 11:46:00
Luxembourg;Total;3034;46;500;2488;546;2020-04-09 11:46:00
Saudi Arabia;Total;2932;41;631;2260;672;2020-04-09 11:46:00
Serbia;Total;2666;65;118;2483;183;2020-04-09 11:46:00
UAE;Total;2659;12;239;2408;251;2020-04-09 11:46:00
Finland;Total;2605;40;300;2265;340;2020-04-09 11:46:00
Panama;Total;2528;63;16;2449;79;2020-04-09 11:46:00
Thailand;Total;2423;32;940;1451;972;2020-04-09 11:46:00
Qatar;Total;2376;6;206;2164;212;2020-04-09 11:46:00
Dominican Republic;Total;2111;108;50;1953;158;2020-04-09 11:46:00
Colombia;Total;2054;55;123;1876;178;2020-04-09 11:46:00
Ukraine;Total;1892;57;45;1790;102;2020-04-09 11:46:00
Greece;Total;1884;83;269;1532;352;2020-04-09 11:46:00
South Africa;Total;1845;18;95;1732;113;2020-04-09 11:46:00
Argentina;Total;1795;65;358;1372;423;2020-04-09 11:46:00
Singapore;Total;1623;6;406;1211;412;2020-04-09 11:46:00
Iceland;Total;1616;6;633;977;639;2020-04-09 11:46:00
Algeria;Total;1572;205;237;1130;442;2020-04-09 11:46:00
Egypt;Total;1560;103;305;1152;408;2020-04-09 11:46:00
Morocco;Total;1346;96;103;1147;199;2020-04-09 11:46:00
Croatia;Total;1343;19;179;1145;198;2020-04-09 11:46:00
New Zealand;Total;1239;1;317;921;318;2020-04-09 11:46:00
Estonia;Total;1207;24;83;1100;107;2020-04-09 11:46:00
Iraq;Total;1202;69;452;681;521;2020-04-09 11:46:00
Moldova;Total;1174;28;43;1103;71;2020-04-09 11:46:00
Slovenia;Total;1124;43;128;953;171;2020-04-09 11:46:00
Belarus;Total;1066;13;77;976;90;2020-04-09 11:46:00
Hungary;Total;980;66;96;818;162;2020-04-09 11:46:00
Hong Kong;Total;974;4;293;677;297;2020-04-09 11:46:00
Lithuania;Total;955;15;8;932;23;2020-04-09 11:46:00
Armenia;Total;921;10;138;773;148;2020-04-09 11:46:00
Kuwait;Total;910;1;111;798;112;2020-04-09 11:46:00
Bosnia and Herzegovina;Total;841;35;95;711;130;2020-04-09 11:46:00
Bahrain;Total;823;5;477;341;482;2020-04-09 11:46:00
Azerbaijan;Total;822;8;63;751;71;2020-04-09 11:46:00
Kazakhstan;Total;764;7;58;699;65;2020-04-09 11:46:00
Cameroon;Total;730;10;60;660;70;2020-04-09 11:46:00
Diamond Princess;Total;712;11;619;82;630;2020-04-09 11:46:00
Slovakia;Total;701;2;16;683;18;2020-04-09 11:46:00
Tunisia;Total;628;24;25;579;49;2020-04-09 11:46:00
North Macedonia;Total;617;29;35;553;64;2020-04-09 11:46:00
Bulgaria;Total;611;24;48;539;72;2020-04-09 11:46:00
Latvia;Total;589;2;16;571;18;2020-04-09 11:46:00
Lebanon;Total;582;19;62;501;81;2020-04-09 11:46:00
Andorra;Total;564;23;52;489;75;2020-04-09 11:46:00
Uzbekistan;Total;555;3;30;522;33;2020-04-09 11:46:00
Cyprus;Total;526;9;52;465;61;2020-04-09 11:46:00
Costa Rica;Total;502;3;29;470;32;2020-04-09 11:46:00
Afghanistan;Total;484;15;32;437;47;2020-04-09 11:46:00
Cuba;Total;457;12;27;418;39;2020-04-09 11:46:00
Oman;Total;457;2;109;346;111;2020-04-09 11:46:00
Uruguay;Total;456;7;192;257;199;2020-04-09 11:46:00
Burkina Faso;Total;414;23;134;257;157;2020-04-09 11:46:00
Albania;Total;409;22;165;222;187;2020-04-09 11:46:00
Ivory Coast;Total;384;3;48;333;51;2020-04-09 11:46:00
Taiwan;Total;380;5;80;295;85;2020-04-09 11:46:00
Réunion;Total;362;0;40;322;40;2020-04-09 11:46:00
Jordan;Total;358;6;150;202;156;2020-04-09 11:46:00
Channel Islands;Total;351;8;38;305;46;2020-04-09 11:46:00
Honduras;Total;343;23;6;314;29;2020-04-09 11:46:00
Niger;Total;342;11;28;303;39;2020-04-09 11:46:00
Malta;Total;337;2;16;319;18;2020-04-09 11:46:00
Bangladesh;Total;330;21;33;276;54;2020-04-09 11:46:00
Ghana;Total;313;6;34;273;40;2020-04-09 11:46:00
San Marino;Total;308;34;45;229;79;2020-04-09 11:46:00
Kyrgyzstan;Total;280;4;35;241;39;2020-04-09 11:46:00
Nigeria;Total;276;6;44;226;50;2020-04-09 11:46:00
Mauritius;Total;273;7;19;247;26;2020-04-09 11:46:00
Bolivia;Total;264;18;2;244;20;2020-04-09 11:46:00
Palestine;Total;263;1;44;218;45;2020-04-09 11:46:00
Montenegro;Total;252;2;4;246;6;2020-04-09 11:46:00
Vietnam;Total;251;0;128;123;128;2020-04-09 11:46:00
Senegal;Total;244;2;113;129;115;2020-04-09 11:46:00
Georgia;Total;214;3;50;161;53;2020-04-09 11:46:00
Sri Lanka;Total;189;7;47;135;54;2020-04-09 11:46:00
Mayotte;Total;184;2;22;160;24;2020-04-09 11:46:00
Faeroe Islands;Total;184;0;136;48;136;2020-04-09 11:46:00
DRC;Total;180;18;9;153;27;2020-04-09 11:46:00
Kenya;Total;179;6;9;164;15;2020-04-09 11:46:00
Isle of Man;Total;171;1;88;82;89;2020-04-09 11:46:00
Venezuela;Total;167;9;65;93;74;2020-04-09 11:46:00
Guinea;Total;164;0;5;159;5;2020-04-09 11:46:00
Martinique;Total;154;6;50;98;56;2020-04-09 11:46:00
Guadeloupe;Total;141;8;43;90;51;2020-04-09 11:46:00
Brunei;Total;135;1;92;42;93;2020-04-09 11:46:00
Djibouti;Total;135;0;25;110;25;2020-04-09 11:46:00
Paraguay;Total;124;5;18;101;23;2020-04-09 11:46:00
Gibraltar;Total;120;0;60;60;60;2020-04-09 11:46:00
Cambodia;Total;117;0;63;54;63;2020-04-09 11:46:00
Rwanda;Total;110;0;7;103;7;2020-04-09 11:46:00
Trinidad and Tobago;Total;107;8;1;98;9;2020-04-09 11:46:00
El Salvador;Total;103;5;10;88;15;2020-04-09 11:46:00
Madagascar;Total;93;0;11;82;11;2020-04-09 11:46:00
Guatemala;Total;87;3;17;67;20;2020-04-09 11:46:00
French Guiana;Total;83;0;43;40;43;2020-04-09 11:46:00
Monaco;Total;81;1;4;76;5;2020-04-09 11:46:00
Liechtenstein;Total;78;1;55;22;56;2020-04-09 11:46:00
Aruba;Total;77;0;14;63;14;2020-04-09 11:46:00
Togo;Total;70;3;23;44;26;2020-04-09 11:46:00
Jamaica;Total;63;4;10;49;14;2020-04-09 11:46:00
Barbados;Total;63;3;8;52;11;2020-04-09 11:46:00
Mali;Total;59;7;16;36;23;2020-04-09 11:46:00
Ethiopia;Total;56;2;4;50;6;2020-04-09 11:46:00
Uganda;Total;53;0;0;53;0;2020-04-09 11:46:00
French Polynesia;Total;51;0;0;51;0;2020-04-09 11:46:00
Congo;Total;45;5;2;38;7;2020-04-09 11:46:00
Cayman Islands;Total;45;1;6;38;7;2020-04-09 11:46:00
Macao;Total;45;0;10;35;10;2020-04-09 11:46:00
Sint Maarten;Total;43;6;1;36;7;2020-04-09 11:46:00
Bahamas;Total;40;7;5;28;12;2020-04-09 11:46:00
Bermuda;Total;39;3;23;13;26;2020-04-09 11:46:00
Zambia;Total;39;1;7;31;8;2020-04-09 11:46:00
Guyana;Total;37;6;8;23;14;2020-04-09 11:46:00
Gabon;Total;34;1;1;32;2;2020-04-09 11:46:00
Eritrea;Total;33;0;0;33;0;2020-04-09 11:46:00
Guinea-Bissau;Total;33;0;0;33;0;2020-04-09 11:46:00
Saint Martin;Total;32;2;7;23;9;2020-04-09 11:46:00
Liberia;Total;31;4;3;24;7;2020-04-09 11:46:00
Haiti;Total;27;1;0;26;1;2020-04-09 11:46:00
Benin;Total;26;1;5;20;6;2020-04-09 11:46:00
Tanzania;Total;25;1;5;19;6;2020-04-09 11:46:00
Myanmar;Total;22;3;1;18;4;2020-04-09 11:46:00
Libya;Total;21;1;8;12;9;2020-04-09 11:46:00
Angola;Total;19;2;2;15;4;2020-04-09 11:46:00
Antigua and Barbuda;Total;19;2;0;17;2;2020-04-09 11:46:00
Syria;Total;19;2;4;13;6;2020-04-09 11:46:00
Maldives;Total;19;0;13;6;13;2020-04-09 11:46:00
Equatorial Guinea;Total;18;0;3;15;3;2020-04-09 11:46:00
New Caledonia;Total;18;0;1;17;1;2020-04-09 11:46:00
Mozambique;Total;17;0;1;16;1;2020-04-09 11:46:00
Laos;Total;16;0;0;16;0;2020-04-09 11:46:00
Mongolia;Total;16;0;4;12;4;2020-04-09 11:46:00
Namibia;Total;16;0;3;13;3;2020-04-09 11:46:00
Dominica;Total;15;0;1;14;1;2020-04-09 11:46:00
Fiji;Total;15;0;0;15;0;2020-04-09 11:46:00
Sudan;Total;14;2;2;10;4;2020-04-09 11:46:00
Curaçao;Total;14;1;7;6;8;2020-04-09 11:46:00
Saint Lucia;Total;14;0;1;13;1;2020-04-09 11:46:00
Botswana;Total;13;1;0;12;1;2020-04-09 11:46:00
Somalia;Total;12;1;1;10;2;2020-04-09 11:46:00
Grenada;Total;12;0;0;12;0;2020-04-09 11:46:00
Eswatini;Total;12;0;7;5;7;2020-04-09 11:46:00
Zimbabwe;Total;11;3;0;8;3;2020-04-09 11:46:00
Greenland;Total;11;0;11;0;11;2020-04-09 11:46:00
Saint Kitts and Nevis;Total;11;0;0;11;0;2020-04-09 11:46:00
Seychelles;Total;11;0;0;11;0;2020-04-09 11:46:00
Suriname;Total;10;1;4;5;5;2020-04-09 11:46:00
Chad;Total;10;0;2;8;2;2020-04-09 11:46:00
MS Zaandam;Total;9;2;0;7;2;2020-04-09 11:46:00
Nepal;Total;9;0;1;8;1;2020-04-09 11:46:00
Montserrat;Total;9;0;0;9;0;2020-04-09 11:46:00
Belize;Total;8;1;0;7;1;2020-04-09 11:46:00
Malawi;Total;8;1;0;7;1;2020-04-09 11:46:00
Turks and Caicos;Total;8;1;0;7;1;2020-04-09 11:46:00
CAR;Total;8;0;0;8;0;2020-04-09 11:46:00
Vatican City;Total;8;0;2;6;2;2020-04-09 11:46:00
St. Vincent Grenadines;Total;8;0;1;7;1;2020-04-09 11:46:00
Cabo Verde;Total;7;1;1;5;2;2020-04-09 11:46:00
Sierra Leone;Total;7;0;0;7;0;2020-04-09 11:46:00
Mauritania;Total;6;1;2;3;3;2020-04-09 11:46:00
Nicaragua;Total;6;1;0;5;1;2020-04-09 11:46:00
St. Barth;Total;6;0;1;5;1;2020-04-09 11:46:00
Bhutan;Total;5;0;2;3;2;2020-04-09 11:46:00
Falkland Islands;Total;5;0;1;4;1;2020-04-09 11:46:00
Gambia;Total;4;1;2;1;3;2020-04-09 11:46:00
Sao Tome and Principe;Total;4;0;0;4;0;2020-04-09 11:46:00
Western Sahara;Total;4;0;0;4;0;2020-04-09 11:46:00
Anguilla;Total;3;0;0;3;0;2020-04-09 11:46:00
British Virgin Islands;Total;3;0;0;3;0;2020-04-09 11:46:00
Burundi;Total;3;0;0;3;0;2020-04-09 11:46:00
Caribbean Netherlands;Total;2;0;0;2;0;2020-04-09 11:46:00
Papua New Guinea;Total;2;0;0;2;0;2020-04-09 11:46:00
South Sudan;Total;2;0;0;2;0;2020-04-09 11:46:00
Saint Pierre Miquelon;Total;1;0;0;1;0;2020-04-09 11:46:00
Timor-Leste;Total;1;0;0;1;0;2020-04-09 11:46:00
China;Total;81865;3335;77370;1160;80705;2020-04-09 11:46:00
